HTML - html
CSS - css
JavaScript - js
ABAP - abap
Augmented Backus-Naur form - abnf
ActionScript - actionscript
Ada - ada
AL - al
ANTLR4 - antlr4
Apache Configuration - apacheconf
APL - apl
AppleScript - applescript
AQL - aql
Arduino - arduino
ARFF - arff
AsciiDoc - asciidoc
6502 Assembly - asm6502
ASP.NET (C#) - aspnet
AutoHotkey - autohotkey
AutoIt - autoit
Bash - bash
BASIC - basic
Batch - batch
BBcode - bbcode
Bison - bison
Backus–Naur form - bnf
Brainfuck - brainfuck
BrightScript - brightscript
Bro - bro
C - c
Concurnas - concurnas
C# - csharp
C++ - cpp
CIL - cil
CoffeeScript - coffeescript
CMake - cmake
Clojure - clojure
Crystal - crystal
Content-Security-Policy - csp
CSS Extras - css-extras
D - d
Dart - dart
DAX - dax
Diff - diff
DNS zone file - dns-zone-file
Docker - docker
Extended Backus–Naur form - ebnf
Eiffel - eiffel
EJS - ejs
Elixir - elixir
Elm - elm
Embedded Lua templating - etlua
ERB - erb
Erlang - erlang
Excel Formula - xlsx
F# - fsharp
Factor - factor
Firestore security rules - firestore-security-rules
Flow - flow
Fortran - fortran
FreeMarker Template Language - ftl
G-code - gcode
GDScript - gdscript
GEDCOM - gedcom
Gherkin - gherkin
Git - git
GLSL - glsl
GameMaker Language - gml
Go - go
GraphQL - graphql
Groovy - groovy
Haml - haml
Handlebars - handlebars
Haskell - haskell
Haxe - haxe
HCL - hcl
HLSL - hlsl
HTTP - http
HTTP Public-Key-Pins - hpkp
HTTP Strict-Transport-Security - hsts
IchigoJam - ichigojam
Icon - icon
Structured Text (IEC 61131-3) - iecst
Inform 7 - inform7
Ini - ini
Io - io
J - j
Java - java
JavaDoc - javadoc
JavaDoc-like - javadoclike
Java stack trace - javastacktrace
Jinja2 - jinja2
Jolie - jolie
JQ - jq
JSDoc - jsdoc
JS Extras - js-extras
JS Templates - js-templates
JSON - json
JSONP - jsonp
JSON5 - json5
Julia - julia
Keyman - keyman
Kotlin - kotlin
LaTeX - latex
Latte - latte
Less - less
LilyPond - lilypond
Liquid - liquid
Lisp - lisp
LiveScript - livescript
LLVM IR - llvm
LOLCODE - lolcode
Lua - lua
Makefile - makefile
Markdown - markdown
Markup templating - markup-templating
MATLAB - matlab
MEL - mel
Mizar - mizar
Monkey - monkey
MoonScript - moonscript
N1QL - n1ql
N4JS - n4js
Nand To Tetris HDL - nand2tetris-hdl
NASM - nasm
NEON - neon
nginx - nginx
Nim - nim
Nix - nix
NSIS - nsis
Objective-C - objectivec
OCaml - ocaml
OpenCL - opencl
Oz - oz
PARI/GP - parigp
Parser - parser
Pascal - pascal
Pascaligo - pascaligo
PC-Axis - pcaxis
PeopleCode - peoplecode
Perl - perl
PHP - php
PHPDoc - phpdoc
PHP Extras - php-extras
PL/SQL - plsql
PowerQuery - powerquery
PowerShell - powershell
Processing - processing
Prolog - prolog
.properties - properties
Protocol Buffers - protobuf
Pug - pug
Puppet - puppet
Pure - pure
PureBasic - purebasic
Python - python
Q (kdb+ database) - q
QML - qml
Qore - qore
R - r
Racket - racket
React JSX - jsx
React TSX - tsx
Ren'py - renpy
Reason - reason
Regex - regex
reST (reStructuredText) - rest
Rip - rip
Roboconf - roboconf
Robot Framework - robotframework
Ruby - ruby
Rust - rust
SAS - sas
Sass (Sass) - sass
Sass (Scss) - scss
Scala - scala
Scheme - scheme
Shell session - shell-session
Smalltalk - smalltalk
Smarty - smarty
Solidity (Ethereum) - solidity
Solution file - solution-file
Soy (Closure Template) - soy
SPARQL - sparql
Splunk SPL - splunk-spl
SQF: Status Quo Function (Arma 3) - sqf
SQL - sql
Stylus - stylus
Swift - swift
TAP - tap
Tcl - tcl
Textile - textile
TOML - toml
Template Toolkit 2 - tt2
Turtle - turtle
Twig - twig
TypeScript - typescript
T4 Text Templates (C#) - t4-cs
T4 Text Templates (VB) - t4-vb
T4 templating - t4-templating
UnrealScript - unrealscript
Vala - vala
VB.Net - vbnet
Velocity - velocity
Verilog - verilog
VHDL - vhdl
vim - vim
Visual Basic - visual-basic
WarpScript - warpscript
WebAssembly - wasm
Wiki markup - wiki
Xeora - xeora
XML doc (.net) - xml-doc
Xojo (REALbasic) - xojo
XQuery - xquery
YAML - yaml
Zig - zig